111111111111111111111111
100000000000000000000001
101110011111111110011101
101000010000000010000101
101010000110111000100101
100000000100001000000001
100000010100000011110001
100011110000001010000001
100000000100001000000001
101001000111011000010101
101000010000000010000101
101110011111111110011101
100000000000000000000001
111111111111111111111111