111111111111111111111111
100000000000000000000001
101111111110011111111101
101000000000000000000101
101001111100001111100101
101001100000000001100101
100000100001100001000001
100000100001100001000001
101001100000000001100101
101001111100001111100101
101000000000000000000101
101111111110011111111101
100000000000000000000001
111111111111111111111111